#########
# H   E #
#       #
##  ##  #
#  P #  #
#      E#
#########