#########
#     E #
#       #
#   #   #
#  P #  #
#       #
#########