#########
#       #
#       #
#   #E  #
#  P #  #
#       #
#########