#########
#     E #
#       #
##  ##  #
#  P #  #
#      E#
#########